#########G#####
#.............#
#.......#######
#.............#
#..##..##.....#
#..##..##.....#
#.............#
#####.........#
#...#.........#
#.#.#..########
#.#.#..#......#
#.#.#.........#
#.####.########
#............M#
###############